1111111111111111111111111111
1222222222222112222222222221
1211112111112112111112111121
1211112111112222111112111121
1211112111112112111112111121
1222223222222112222223222221
1211112112111111112112111121
1211112112111111112112111121
1222222112222112222112222221
1112112111112112111112112111
1112112111112112111112112111
1222112222222222222222112221
1211112112110000112112111121
1211112112106007012112111121
1222224112100000012114222221
1211112112108009012112111121
1211112112111111112112111121
1222112112222222222112112221
1112112112111111112112112111
1222223222222522222223222221
1211112111112112111112111121
1222112222222112222222112221
1112112112111111112112112111
1112112112111111112112112111
1222222112222112222112222221
1211112111112112111112111121
1222222222222222222222222221
1111111111111111111111111111