1111111111111111111111111111
1322222222222112222222222231
1211112111112112111112111121
1211112111112222111112111121
1211112111112112111112111121
1222224222222112222224222221
1211112112111111112112111121
1211112112111111112112111121
1222222112222112222112222221
1112112111112112111112112111
1112112111112112111112112111
1222112222222222222222112221
1211112112110000112112111121
1211112112106007012112111121
1222222112100000012112222221
1211112112108009012112111121
1211112112111111112112111121
1222112112222222222112112221
1112112112111111112112112111
1222224222222522222224222221
1211112111112112111112111121
1222112222222112222222112221
1112112112111111112112112111
1112112112111111112112112111
1222222112222112222112222221
1211112111112112111112111121
1322222222222222222222222231
1111111111111111111111111111