0000000000000000
0000000000001000
1011111111101000
1000001000001000
1111101011111000
0000001010000000
1111001010000000
0000001010000000
0000001010000000
0000000000000000
0000000000000000
0000000000000000
0000000000000000
0000000000000000
0000000000000000
0000000000000000