1111111111111111
1000000000000001
1001111111111101
1011111111111101
1010000000000001
1010111111111111
1010111100010001
1000000101010101
1010110001010101
1010111111010101
1010100000010101
1010100111110101
1010100000000101
1010111111111101
1010000000000001
1111111111111111