0020000000000000
0000000000000000
0000000000000000
0000001010000000
0000001010000000
0000001010000000
1111111011111111
0000000000000000
1111111011111111
0000001010000000
0000001010000000
0000201010000000
0000001010000000
0000001010000000
0000000000000000
0000000000000000